111111111111111111111
100000000000000000001
100000000000000000001
1000000000E0001110001
100000001110001000001
1P0C00001000001000001
111110111110111111111
111110000000000000001
111111111111111111111