111111111111111111111111111111111111111111111111
100000000000000000000C00000000000000000000000001
1000000000000100000000C0000000000000111000000001
10000C000000000100000000000100000000011100000001
1000000000000000000000000000000000C00000000000E1
10000000000C000000000000000011100000000000000001
100000000000000000000000000011100000000000000001
10000000000000000000C000000000000000000000000001
100000000000000000000000000000000000000000000001
100000000000000000000000000000000000000000000001
100000000000000000000000000000000000C00000000001
100000000000000000001110000000000000000000000001
100000000000000000001110000000000000000000000001
100000000000000000001110000000000000000000000001
10000000C000000000000000000000000000000000000001
100000000000000000000000000000000000000000000001
100000000000000000000000000000000000000000000001
100000000000000000000000000000011100000011000001
100000001000000000000000000000000000000000000001
100000000000000000C00000000000000000000000000001
1000000000000000000000000000000000000000C0000001
100000010000000000000000000000000000000000000001
10000001100000000000000C000000000000000000000001
1P0000000000000000000000000000000000000000000001
111111111111111111111111111111111111111111111111