1111111111111111
1P00000000000001
1000000000000001
100000000E000001
100C000000000001
1111111111111111
