11111111111111111
10000000000000001
100000000C0000001
10000000000000001
1P000000000000001
11111111111111111