11111111111111111
100C0000000000001
10000000000000P01
1P000000000000E011
11111111111111111