11111111111111111
10000000000000001
10000000C00000001
100000000000000E1
1P000000000000000
11111111111111111