111111111111111111
100000000000000001
1000000000000E0001
100P00000000000001
111111111111111111