1111111111111111111111111111111111111111111111111
1000000000000000000000000000000000000000000000001
1000000000000000000000000000000000000000000000001
100000000C000000000000000000C00000000000000000001
1000000000000000000000000000000000000000000000001
1000000000000000000000000000000000000000000000001
10000000000000000000000000000000000000000000E0001
1000000000000000000000000000000000000000000000001
1000000000000000000000000000000000000000000000001
1000000000000000000000000000C00000000000000000001
1000000C00000000000000000000000000000000000000001
1000000000000000000000000000000000000000000000001
1000000000000000000000111000000000000000000000001
1000000000000000000000111000000000000000000000001
1000000000000000000000111000000000000000000000001
1000000000000000000000000000000000000000000000001
100000000000000000000000000000C00000000000C000001
1000000000000000000000000000000000000000000000001
1000000000000000000000000000000000000000000000001
1000000000000000000000000000000000000000000000001
1000000000000110000000000000000000000000000000001
1000000000000000000000000000000000000C00000000001
1000000000000000000000000000000000000000000000001
1000000000000000000000000000000000000000000000001
1P00000000000000000000000000000000000000000000001
1111111111111111111111111111111111111111111111111