11111111111111111111
10000E00000000000001
10000000000000000E01
10000000000C00000001
1P000000000000000001
11111111111111111111