1111111111111111111111
10000000000000000001C1
1P00000000000000000011
1000000000E00000000001
1000000000000000000001
1000000000000000000001
1111111111111111111111