1111111111111111
1P00000001000001
1000C00010000001
1000000100000001
1000001000000E01
1111111111111111