1111111111111111111111
1P000000000000J0000001
1000000000000000000001
10000000000E0000000001
1000C00000000000000001
1111111111111111111111